%%%%%%%%%%%%%%%%%%%%
%o.....     .......%
%...     ..... ....%
%.   .... .........%
%..........   .....%
%......    G ......%
%.         ........%
%.... ......    ...%
%..................%
%.... ...P........o%
%%%%%%%%%%%%%%%%%%%%