%%%%%%%%
%P     %
% .%%. %
% .% . %
% .%%. %
%     G%
%%%%%%%%