%%%%%%%%
%P    .%
% .%%. %
% .%.. %
% .%%. %
%     G%
%%%%%%%%