%%%%%%%%
%P     %
% .%%. %
% .%.. %
% .%%. %
%     G%
%%%%%%%%